ARO = "countries/Autonomous Republic Opolchenie.txt"
OPO = "countries/Opolchenie.txt"
EVD = "countries/Evdokimia.txt"
FAL = "countries/Falleland.txt"
GAR = "countries/Gardernia.txt"
JJK = "countries/Jojonianskoe Knyazhestvo.txt"
EPI = "countries/Epicana.txt"
KIR = "countries/Kirovsk.txt"
PAR = "countries/Partizania.txt"
PER = "countries/Persya.txt"
SHL = "countries/Shlepenia.txt"
BAL = "countries/Baltikania.txt"
ZEL = "countries/Zelenyi Krest.txt"
ORD = "countries/Orden.txt"
REP = "countries/Nenstvo Repya.txt"
MOH = "countries/Morshustan.txt"
KEZ = "countries/Kekzahstan.txt"
REZ = "countries/Reznia.txt"
POS = "countries/Postreborniya.txt"
OMH = "countries/Old Morshustan.txt"
KMH = "countries/Kommorshustan.txt"
SER = "countries/Sersiya.txt"
KAL = "countries/Kalinia.txt"
CHM = "countries/Chimsland.txt"
AMG = "countries/Amogusia.txt"
AUT = "countries/Autodomia.txt"
IZG = "countries/Izgoi Kek.txt"
UNI = "countries/Univerland.txt"
XXX = "countries/Spectator.txt"

#NOTE: Useful to add a basic default loc entry for each tag in 00_countries.txt so that hovering over a tag will show the tag's name in loc (ie. PAP: "Papal States")
